########
#P.....#
#..##..#
#..F...#
########