###########################
# P.......................#
#......######.............#
#.........................#
#......######.....#####...#
#...........#.............#
#...........#######.......#
#############.............#
#...........#.............#
#...........#.............#
#...........#.............#
#...........F.............#
###########################