S##############
 #   #       #
 # # # ##### #
 # #       # #
 # ####### # #
 #         # #
 ########### #
 #         # #
 # ####### # #
 # #     # # #
 # # ### # # #
 # #   # # # #
 # ### #   # #
 #     ##### #
##############E