S#########
         #
 # ##### #
 #     # #
 ##### # #
 #   # # #
 # # # # #
 # #   # #
 #      E#
##########