S##############
 #   #        #
 # # # #####  #
 # #       #  #
 # ####### #  #
 #         #  #
 ###########  #
 #            #
 # ####### #  #
 # #     # #  #
 # # ### # #  #
 # #   # # #  #
 # ### #   #  #
       ##### E#
###############