#########
#S  #   #
# # # # #
# #   # #
#   ###E#
#########