#########
#S  #   #
# # # # #
# #   #E#
#   ### #
#########