S#########
 #       #
 # ##### #
 #     # #
 ##### # #
 #   # # #
 # # # # #
 # #   # #
 #       #
#########E